BLACK	B L AE K
BLUE	B L UW
EIGHT	EY T
FIVE	F AY V
FOUR	F AO R
GRAY	G R EY
GREEN	G R IY N
INTEL	IH N T EH L
NINE	N AY N
NO	N OW
ONE	W AH N
ONE(2)	HH W AH N
PLEASE	P L IY Z
RED	R EH D
SEVEN	S EH V AH N
SIX	S IH K S
TASTY	T EY S T IY
TEN	T EH N
THREE	TH R IY
TWO	T UW
WHITE	W AY T
WHITE(2)	HH W AY T
YES	Y EH S
